S.no,Name,M1,M2,C,Python,Total Marks
1,chaitu,80,85,80,90,335
2,siri,80,82,90,90,342
3,durga,70,80,90,80,320
4,liki,75,90,70,67,302
5,rupa,65,80,90,93,328
6,keerthi,70,90,69,89,318
7,pavani,80,70,74,67,291
8,moni,85,80,82,82,329
9,ammu,80,90,69,59,298
10,sri,60,90,65,70,285
